11111111111111111111111111111111
1..............................1
1..S....................... ...1
1............1.................1
1..L.........1.................1
1............1....1............1
11111111111111111111...........1
1......1.....1....1............1
1......1.....1.................1
1......1.....1.................1
1......1.....1.................1
1......1.....1.................1
1..............................1
1..............................1
11111111111111111111111111111111
